108 310 159 389 291 98 248 632 421
108 390 142 477 278 98 248 632 421
108 223 179 331 301 98 248 632 421
109 1 161 62 313 2 212 246 328
109 220 180 299 303 94 250 634 426
109 303 159 391 415 94 250 634 426
109 385 141 474 401 94 250 634 426
