577 367 70 492 423 334 2 599 146
577 177 57 384 425 59 3 347 139
579 177 61 395 422 69 1 354 143
582 369 75 508 414 341 2 600 179
582 174 48 377 424 68 6 350 143
