313 1 234 30 320 22 220 144 299
313 183 203 280 411 267 189 447 378
323 284 246 296 260 270 195 441 384
323 14 216 30 227 26 227 84 272
323 565 219 580 237 270 195 441 384
323 279 229 295 245 270 195 441 384
323 251 240 266 259 270 195 441 384
323 21 369 32 403 270 195 441 384
323 38 210 63 227 26 227 84 272
323 521 226 539 262 270 195 441 384
323 549 234 562 293 270 195 441 384
323 1 324 28 354 270 195 441 384
323 1 363 22 407 270 195 441 384
323 11 353 40 387 108 218 250 351
323 255 261 271 319 270 195 441 384
323 557 239 576 293 270 195 441 384
323 273 251 291 312 270 195 441 384
323 531 232 550 291 270 195 441 384
323 585 238 607 295 270 195 441 384
323 33 248 53 341 26 227 84 272
323 1 231 28 327 26 227 84 272
323 68 208 111 387 26 227 84 272
323 187 207 279 409 270 195 441 384
