131 255 14 429 275 282 135 418 453
133 270 9 422 268 258 102 426 444
139 265 11 424 268 254 125 405 445
141 252 2 449 279 233 88 459 471
142 251 11 426 268 250 150 416 451
