392 343 79 360 137 271 319 417 456
392 261 82 279 148 271 319 417 456
392 361 81 380 156 271 319 417 456
392 305 81 330 149 271 319 417 456
392 212 90 248 155 271 319 417 456
392 440 75 479 340 271 319 417 456
