11 232 261 246 294 233 276 250 292
11 273 231 318 364 285 309 317 374
18 274 236 322 351 288 278 312 369
19 217 262 227 279 215 274 226 284
19 232 259 252 289 234 278 246 290
19 274 234 318 354 293 284 317 374
20 278 236 319 335 283 279 311 371
