18 34 290 80 397 34 334 73 424
19 34 286 78 406 33 335 90 416
20 36 285 79 404 47 340 69 420
67 570 295 591 326 536 280 639 402
73 230 336 241 345 216 330 262 369
73 384 316 401 329 361 310 445 374
73 469 315 485 330 440 304 542 381
73 502 318 519 334 440 304 542 381
73 269 312 288 330 254 304 318 370
73 323 306 344 324 307 296 381 368
73 569 294 601 325 533 278 639 405
