75 17 62 41 84 614 110 639 174
75 17 62 41 84 1 116 36 202
75 17 62 41 84 408 67 558 180
75 17 62 41 84 1 118 566 444
75 14 49 32 81 614 110 639 174
75 14 49 32 81 1 116 36 202
75 14 49 32 81 408 67 558 180
75 14 49 32 81 1 118 566 444
