38 394 276 432 307 78 273 589 344
38 299 218 361 299 78 273 589 344
38 239 206 303 294 78 273 589 344
38 197 204 263 290 78 273 589 344
38 334 221 409 302 78 273 589 344
39 235 206 306 296 72 270 590 345
41 198 207 257 290 74 278 587 342
41 298 219 359 301 74 278 587 342
41 334 223 406 302 74 278 587 342
41 237 205 306 295 74 278 587 342
