283 280 70 572 506 421 225 458 254
283 22 90 335 508 81 321 106 342
284 280 69 576 506 414 216 458 271
284 25 86 334 506 80 316 114 352
285 21 91 336 504 80 316 116 343
285 276 72 577 506 418 225 458 254
288 22 93 319 508 83 307 122 352
288 279 65 575 508 411 216 456 286
