208 407 199 449 279 406 211 424 258
208 222 242 257 340 214 256 250 307
208 261 226 305 318 262 243 282 278
208 315 212 370 309 318 225 350 275
208 158 247 216 412 161 257 208 330
208 32 274 143 478 47 316 134 382
212 268 233 302 322 263 249 282 281
212 417 206 463 283 401 215 439 258
212 330 218 373 317 317 223 355 274
212 215 246 262 340 218 258 255 308
212 161 257 222 401 158 263 210 327
212 78 261 142 472 124 285 137 316
212 41 266 175 478 47 309 125 391
