146 194 27 453 295 29 83 607 413
152 192 34 450 292 43 91 603 412
153 173 34 460 308 38 137 606 420
154 183 24 459 301 40 90 607 415
155 212 25 452 293 45 106 607 407
