538 25 11 241 421 82 192 166 334
540 13 6 247 424 94 205 168 342
541 1 72 68 298 102 198 157 344
541 8 6 250 427 102 198 157 344
541 162 123 639 423 102 198 157 344
544 1 6 232 422 102 203 152 362
