470 613 68 634 101 603 98 633 110
470 549 86 579 175 521 164 592 180
470 384 93 438 235 384 216 446 243
470 334 118 392 261 352 240 398 274
470 202 74 295 306 182 278 292 346
470 265 234 410 421 250 382 442 433
471 613 69 636 108 606 96 633 111
471 541 85 581 175 519 162 591 177
471 385 91 442 232 378 218 450 247
471 331 116 390 262 349 234 388 282
471 185 81 294 301 174 266 294 351
471 263 229 412 424 251 374 450 442
472 549 84 581 166 521 162 604 183
472 390 92 438 235 374 217 457 250
472 336 114 389 259 356 244 401 282
472 204 79 294 291 190 270 288 347
472 274 237 405 406 254 390 446 439
