483 344 86 499 332 321 147 374 171
483 168 130 318 392 226 186 300 227
484 73 90 302 402 235 190 295 226
486 80 120 306 402 214 182 293 220
486 244 70 514 403 314 150 378 171
