18 622 110 639 150 614 129 637 177
18 592 108 611 161 587 135 619 189
18 553 98 577 167 553 123 581 194
18 487 120 526 173 503 151 532 199
18 406 113 438 180 401 161 448 217
18 462 121 504 173 476 149 505 217
18 441 128 482 197 447 173 480 238
18 332 114 382 190 343 169 388 239
18 372 130 427 203 383 173 428 253
18 306 132 362 265 312 191 373 272
18 241 115 309 265 249 177 322 278
18 177 123 246 284 166 184 261 305
18 92 141 185 317 94 208 197 322
20 433 125 493 243 442 165 492 243
