146 427 76 534 269 426 117 515 305
146 66 154 246 293 62 194 196 293
152 407 87 544 249 413 140 525 313
152 75 146 239 298 51 174 218 304
153 99 140 235 294 50 183 220 299
153 412 82 523 278 414 135 519 314
155 407 87 542 251 411 145 530 298
155 65 147 242 298 46 174 219 303
156 408 83 543 254 411 138 527 318
156 72 138 258 302 46 176 221 308
