454 180 13 297 257 182 259 280 335
454 501 101 609 373 501 343 596 384
454 26 51 145 314 41 265 103 361
454 335 18 457 311 345 305 457 377
457 177 12 298 264 173 256 293 338
457 496 91 620 376 499 333 604 387
457 18 43 150 317 37 260 106 363
457 341 13 465 317 343 297 461 381
459 173 9 299 263 173 250 293 339
459 496 98 615 377 496 330 602 393
459 11 46 150 317 31 257 106 364
459 339 10 463 316 339 301 464 381
461 502 104 596 371 498 337 597 377
461 185 14 295 261 171 256 282 329
461 22 44 146 313 41 263 102 365
461 341 17 461 313 344 303 459 381
