53 128 120 219 362 331 94 367 123
53 128 120 219 362 351 78 382 225
53 128 120 219 362 6 87 58 202
53 128 120 219 362 262 82 333 231
53 128 120 219 362 3 19 195 596
