357 214 67 343 244 477 240 496 284
357 155 104 318 280 475 234 509 243
357 19 74 264 351 474 256 516 268
361 225 38 361 242 431 230 514 254
361 518 3 639 240 502 194 544 242
361 150 103 311 291 442 237 499 253
361 387 14 554 234 451 223 497 249
361 10 80 286 346 464 255 518 274
