314 151 243 306 571 97 70 422 556
316 95 10 217 294 92 71 422 497
316 152 237 305 579 92 71 422 497
319 152 245 303 569 100 86 422 554
320 107 15 207 289 100 83 383 552
320 151 241 302 571 100 83 383 552
