357 1 2 419 471 434 286 535 305
357 1 2 419 471 446 298 546 322
357 1 2 419 471 451 314 573 343
357 1 2 419 471 482 346 611 379
357 1 2 419 471 466 319 602 351
361 1 6 418 478 460 320 551 351
