108 285 92 407 224 103 211 552 420
109 188 69 278 252 110 202 516 426
109 287 84 412 222 110 202 516 426
109 62 70 182 309 110 202 516 426
109 550 98 639 423 110 202 516 426
109 444 207 615 423 110 202 516 426
109 1 115 175 423 110 202 516 426
