370 237 362 246 376 155 165 172 187
370 237 362 246 376 214 145 237 164
370 248 359 257 374 282 106 294 123
370 248 359 257 374 229 174 245 195
370 269 357 281 371 318 151 333 173
370 269 357 281 371 285 199 312 223
370 539 339 554 354 412 100 430 113
370 539 339 554 354 416 127 433 142
370 511 342 527 358 481 265 497 283
370 526 340 538 362 395 97 413 115
374 237 358 249 372 416 126 430 140
374 237 358 249 372 479 266 498 278
374 237 358 249 372 283 107 296 126
374 237 358 249 372 228 177 244 194
374 237 358 249 372 399 96 414 115
374 237 358 249 372 415 96 432 116
374 237 358 249 372 151 166 171 185
374 237 358 249 372 318 149 334 175
374 237 358 249 372 216 144 236 165
374 237 358 249 372 282 201 308 220
374 267 353 280 369 416 126 430 140
374 267 353 280 369 479 266 498 278
374 267 353 280 369 283 107 296 126
374 267 353 280 369 228 177 244 194
374 267 353 280 369 399 96 414 115
374 267 353 280 369 415 96 432 116
374 267 353 280 369 151 166 171 185
374 267 353 280 369 318 149 334 175
374 267 353 280 369 216 144 236 165
374 267 353 280 369 282 201 308 220
