516 172 217 289 432 25 257 366 378
516 93 222 209 535 25 257 366 378
518 172 212 302 432 23 267 366 384
518 89 218 198 538 23 267 366 384
519 174 219 289 434 19 275 362 378
522 177 219 254 296 28 275 364 377
522 87 222 194 534 28 275 364 377
