38 232 469 321 494 130 29 339 518
40 249 478 273 501 154 46 334 513
41 237 476 248 493 120 53 344 516
41 206 477 217 499 120 53 344 516
41 270 475 282 496 120 53 344 516
41 222 481 238 500 120 53 344 516
41 249 479 263 501 120 53 344 516
41 296 474 317 493 120 53 344 516
41 287 470 302 498 120 53 344 516
