575 406 159 465 369 464 134 568 262
575 352 162 414 418 464 134 568 262
575 464 154 542 390 464 134 568 262
575 142 159 260 474 464 134 568 262
575 245 118 352 474 464 134 568 262
575 4 89 138 470 464 134 568 262
575 491 16 627 474 464 134 568 262
