11 335 36 487 311 205 116 554 363
11 85 83 327 426 205 116 554 363
18 335 39 484 308 211 122 553 359
19 330 37 487 314 204 117 556 363
20 309 41 492 314 202 119 563 364
