56 493 163 578 243 11 45 636 444
57 278 197 352 399 36 62 625 422
60 181 174 224 235 41 65 619 394
60 58 201 90 334 41 65 619 394
60 510 151 568 242 41 65 619 394
60 275 193 355 403 41 65 619 394
61 255 171 281 235 28 58 626 442
61 190 173 217 237 28 58 626 442
61 145 182 182 270 28 58 626 442
61 500 160 561 242 28 58 626 442
