284 309 189 362 289 320 198 331 214
284 264 180 322 295 281 207 290 223
284 50 169 102 318 70 171 86 186
284 221 158 278 297 251 172 265 192
284 325 127 394 323 372 165 394 197
284 398 145 474 333 394 164 412 191
285 310 195 349 288 322 199 332 210
285 267 186 319 288 283 210 291 220
285 339 146 389 318 382 171 394 186
285 404 153 459 324 400 172 410 186
288 309 190 349 290 322 198 333 213
288 266 187 317 291 282 210 292 222
288 338 146 394 321 386 171 396 190
288 398 150 466 325 401 167 410 187
