131 439 85 503 199 423 140 511 279
131 539 73 630 218 551 109 626 299
131 182 37 272 202 119 74 306 286
131 290 84 371 271 274 127 386 290
133 183 38 275 204 126 77 316 294
138 441 87 500 200 420 135 521 286
138 542 73 627 218 544 112 631 303
138 286 82 377 274 277 125 390 298
138 159 35 273 214 122 65 316 297
139 427 91 496 202 419 148 513 274
139 551 76 618 212 554 115 619 302
139 285 85 369 267 273 134 389 290
139 180 38 274 206 118 79 313 289
140 440 87 503 205 423 143 514 279
141 443 86 503 209 424 143 509 273
141 545 78 631 217 555 120 626 300
141 289 85 371 272 268 130 385 295
141 142 36 276 206 127 82 299 295
