596 48 101 242 442 178 216 376 464
596 235 79 446 402 178 216 376 464
597 225 82 435 398 175 222 376 480
597 50 98 246 437 175 222 376 480
598 231 32 442 409 170 214 401 483
598 42 85 253 463 170 214 401 483
