477 199 66 306 162 214 128 275 169
478 223 78 275 151 214 135 260 155
479 222 78 275 152 214 137 262 155
480 223 78 275 152 211 134 263 156
481 224 80 273 149 215 138 259 154
