108 362 147 542 307 126 238 521 479
108 120 149 346 364 126 238 521 479
108 80 180 248 479 126 238 521 479
108 2 53 216 478 126 238 521 479
108 294 185 623 478 126 238 521 479
109 425 150 546 294 126 220 521 470
109 90 193 176 399 126 220 521 470
109 140 158 310 286 126 220 521 470
109 478 187 603 479 126 220 521 470
