89 1 110 136 378 47 353 123 425
89 96 110 275 392 150 374 211 425
248 93 103 274 404 191 186 285 263
249 114 98 277 373 196 194 285 249
250 97 109 258 396 190 196 285 249
