558 1 211 89 423 39 388 160 423
558 163 211 275 422 220 391 305 422
558 1 1 139 185 45 117 118 153
558 324 212 454 422 404 384 485 421
558 163 1 310 190 225 117 321 169
558 324 1 476 193 414 128 486 169
558 488 2 638 202 585 126 637 165
558 488 213 636 423 581 382 636 416
559 488 214 637 423 583 383 638 416
