115 1 278 268 476 1 244 318 449
115 319 268 578 477 322 246 636 438
118 478 96 603 241 335 9 596 206
118 158 31 318 226 24 85 275 192
118 47 276 275 461 28 255 267 441
118 342 262 607 468 369 247 615 389
