11 82 298 114 361 93 325 118 366
11 160 180 298 429 137 288 302 482
13 82 297 114 367 95 327 118 366
13 158 179 306 430 135 266 297 479
20 161 182 276 430 140 278 300 481
