56 229 201 299 237 137 125 579 337
60 120 208 137 282 131 108 600 348
60 95 217 115 319 131 108 600 348
60 215 191 251 257 131 108 600 348
60 263 189 306 261 131 108 600 348
60 18 207 67 343 131 108 600 348
61 222 203 253 247 138 106 586 342
