108 306 75 443 226 126 234 518 478
108 89 84 211 326 126 234 518 478
108 3 114 229 480 126 234 518 478
108 422 68 638 474 126 234 518 478
109 423 58 634 472 122 201 523 477
