131 458 46 530 112 464 93 567 273
139 456 48 535 104 410 94 566 261
140 312 191 326 212 303 199 332 224
140 455 46 527 130 401 94 572 267
141 456 40 520 119 467 90 559 269
