248 310 277 395 398 322 336 386 381
248 401 286 478 456 415 334 480 386
248 112 272 203 476 118 338 193 374
248 225 278 328 499 255 344 323 390
249 312 279 398 395 323 350 385 381
249 398 284 465 455 409 344 480 383
249 111 280 203 471 118 338 192 380
249 233 283 322 499 250 352 325 378
250 316 282 398 394 326 357 382 378
250 400 290 463 451 414 345 482 379
250 111 283 199 474 118 346 191 378
250 223 283 323 498 250 357 320 382
