32 230 183 438 377 2 157 636 425
38 65 210 183 395 2 148 633 427
41 68 223 201 376 2 157 637 427
41 233 183 432 372 2 157 637 427
41 301 117 488 337 2 157 637 427
