208 102 292 174 563 107 318 178 422
208 186 348 278 630 130 339 238 512
208 241 393 355 638 246 334 364 446
208 336 325 474 634 446 361 476 581
212 258 342 345 638 264 338 351 465
212 131 330 247 634 97 338 228 509
212 362 303 474 636 455 370 478 418
