25 3 95 260 475 268 348 311 378
26 7 93 318 469 332 460 373 476
26 7 93 318 469 268 346 334 376
26 7 93 318 469 311 320 363 360
26 7 93 318 469 448 308 514 355
26 7 93 318 469 562 353 635 425
26 7 93 318 469 362 308 448 376
26 7 93 318 469 504 392 585 473
26 7 93 318 469 38 10 197 100
29 2 94 309 479 499 329 512 342
29 2 94 309 479 596 342 609 355
29 2 94 309 479 544 333 557 351
29 2 94 309 479 567 348 586 361
29 2 94 309 479 608 331 633 347
29 2 94 309 479 354 460 376 478
29 2 94 309 479 324 463 353 479
29 2 94 309 479 603 405 631 427
29 2 94 309 479 263 347 313 377
29 2 94 309 479 298 329 336 376
29 2 94 309 479 312 320 369 363
29 2 94 309 479 443 300 511 353
29 2 94 309 479 360 313 441 378
29 2 94 309 479 564 343 631 433
29 2 94 309 479 498 396 588 471
