532 138 81 156 122 83 232 283 382
532 375 74 407 107 83 232 283 382
532 149 71 182 113 83 232 283 382
532 29 74 65 119 83 232 283 382
532 165 61 211 109 83 232 283 382
532 79 75 132 122 83 232 283 382
532 303 50 342 115 83 232 283 382
532 46 63 90 124 83 232 283 382
532 333 62 390 117 83 232 283 382
532 530 60 582 137 83 232 283 382
532 530 2 639 344 83 232 283 382
