152 248 66 468 389 250 154 455 434
153 250 65 470 387 249 161 470 429
154 247 65 474 391 253 151 456 434
155 251 60 463 218 241 192 528 439
156 251 61 469 391 250 168 461 432
