208 178 113 254 257 184 126 226 194
208 490 117 548 320 523 141 562 206
208 332 143 455 439 365 234 449 311
212 178 108 258 266 182 127 234 189
212 484 112 567 317 495 132 567 206
