53 498 126 635 423 90 230 174 425
53 21 113 259 364 90 230 174 425
594 42 185 77 219 371 334 426 413
594 119 112 260 367 371 334 426 413
594 499 126 637 421 371 334 426 413
