108 488 114 637 328 109 214 634 474
108 322 89 506 275 109 214 634 474
108 2 117 270 458 109 214 634 474
109 325 90 502 266 82 159 637 478
109 468 116 637 329 82 159 637 478
109 1 122 264 461 82 159 637 478
