3 49 200 281 481 3 2 637 481
3 369 195 638 481 3 2 637 481
6 474 165 634 466 206 34 501 447
6 42 168 272 455 206 34 501 447
7 15 190 286 482 2 2 639 483
7 365 170 639 482 2 2 639 483
