11 75 122 150 260 72 195 149 326
11 376 82 492 330 370 214 478 406
18 71 116 146 298 74 194 154 331
18 446 96 516 329 434 203 514 381
18 484 89 565 294 495 190 559 358
18 312 108 384 342 310 200 397 354
18 140 107 240 349 151 202 239 382
18 233 95 338 357 245 206 346 388
18 378 82 490 358 378 211 485 406
19 78 123 147 294 78 195 146 320
19 483 94 559 287 487 191 559 342
19 450 103 511 344 442 210 484 368
19 310 114 379 332 306 206 381 351
19 145 103 234 346 145 207 235 367
19 238 99 335 335 238 207 342 386
19 376 80 494 375 383 217 486 408
20 78 120 149 298 82 186 138 330
20 312 62 378 329 318 206 372 368
20 430 66 506 332 445 202 488 381
20 472 80 568 293 499 185 565 367
20 142 94 232 344 155 186 226 366
20 237 82 341 342 246 193 328 406
20 386 56 489 362 389 194 459 431
