13 169 197 214 273 141 248 243 302
13 202 84 397 431 214 233 385 500
18 164 198 216 292 151 247 227 313
20 167 199 210 293 149 248 231 312
20 191 70 385 441 204 239 375 514
