146 69 49 414 517 82 139 450 635
147 65 46 407 525 79 159 459 637
150 59 42 413 516 77 135 457 635
154 61 42 422 527 59 145 454 623
155 61 52 409 543 85 134 455 637
