274 505 76 639 213 401 238 423 250
274 505 76 639 213 94 236 110 253
274 505 76 639 213 327 97 347 113
274 505 76 639 213 215 279 235 296
274 505 76 639 213 419 127 439 145
274 505 76 639 213 395 215 415 232
274 505 76 639 213 255 176 273 195
274 505 76 639 213 460 138 478 158
274 505 76 639 213 451 159 488 170
274 505 76 639 213 145 240 172 256
274 505 76 639 213 391 339 419 355
274 505 76 639 213 280 121 306 140
274 505 76 639 213 486 206 513 224
274 505 76 639 213 207 248 237 265
274 505 76 639 213 480 228 508 247
274 505 76 639 213 322 153 349 172
274 505 76 639 213 415 260 444 279
274 505 76 639 213 419 295 448 315
274 505 76 639 213 505 264 526 292
274 505 76 639 213 196 197 228 215
274 505 76 639 213 217 114 246 134
274 505 76 639 213 323 267 354 286
274 505 76 639 213 454 309 485 328
274 505 76 639 213 145 120 172 142
274 505 76 639 213 149 198 179 219
274 505 76 639 213 211 223 246 240
274 505 76 639 213 342 304 371 326
274 505 76 639 213 418 324 449 346
274 505 76 639 213 228 176 253 204
274 505 76 639 213 186 213 207 247
274 505 76 639 213 379 148 398 190
274 505 76 639 213 357 225 388 251
274 505 76 639 213 266 321 311 341
274 505 76 639 213 93 270 128 297
274 505 76 639 213 449 256 475 303
274 505 76 639 213 144 148 183 184
280 511 86 637 219 322 157 349 175
280 511 86 637 219 380 157 397 188
280 511 86 637 219 319 183 347 204
280 511 86 637 219 307 172 332 197
