11 1 30 148 337 1 138 225 377
11 206 4 390 389 149 129 542 395
18 2 28 149 341 2 134 229 350
18 206 4 391 386 143 143 545 394
19 1 24 138 327 1 134 223 374
19 246 1 384 385 154 156 545 392
20 210 3 382 378 153 148 541 393
