18 185 208 207 240 181 248 210 277
18 170 213 194 266 154 262 197 309
18 201 211 226 262 201 251 231 288
18 240 214 262 273 231 259 257 296
18 257 214 287 264 265 256 293 289
18 301 213 339 268 290 257 342 302
18 267 233 327 294 263 272 319 338
18 393 222 465 323 374 273 474 342
18 528 206 627 422 511 306 634 435
19 391 227 462 339 378 266 474 354
20 269 222 323 318 262 253 329 345
