248 478 4 632 265 503 100 637 218
248 334 13 525 295 453 164 635 327
248 228 87 446 358 194 199 411 377
248 8 119 280 445 5 282 283 467
249 477 5 634 317 533 113 636 204
249 351 21 510 333 440 188 637 316
249 188 82 425 421 201 205 410 390
249 1 101 271 478 3 298 265 474
250 351 16 509 316 198 210 413 379
