96 70 211 194 475 235 93 378 369
96 70 211 194 475 304 170 636 471
96 70 211 194 475 290 121 636 461
96 124 123 274 462 235 93 378 369
96 124 123 274 462 304 170 636 471
96 124 123 274 462 290 121 636 461
