152 447 50 608 164 433 107 617 292
152 257 53 432 295 185 131 480 387
153 478 54 612 214 451 103 618 304
153 266 54 440 276 184 151 499 377
154 442 50 611 166 422 98 626 303
154 254 57 435 298 180 131 490 391
155 443 52 610 166 422 100 622 300
155 256 58 443 295 181 132 479 389
156 445 50 610 177 433 95 628 299
156 266 47 429 293 181 124 469 374
