11 121 194 273 506 83 306 278 539
11 290 147 482 526 244 316 491 546
18 269 124 496 531 222 303 496 562
19 275 134 496 533 232 300 491 562
20 141 186 278 457 90 319 283 541
20 287 145 468 535 240 301 506 553
