454 169 100 249 225 185 203 234 231
454 347 116 540 270 437 218 479 305
459 169 98 238 227 181 210 245 228
459 348 113 539 272 437 225 482 297
461 153 97 255 234 181 197 244 237
461 343 109 540 281 427 225 493 301
