208 219 54 434 611 294 52 447 284
212 236 53 463 617 263 70 436 250
283 222 66 438 605 297 178 330 212
284 227 49 437 620 292 153 329 213
285 235 52 424 614 296 182 324 199
