38 273 188 374 269 144 245 505 306
39 134 213 192 265 114 209 522 315
39 230 202 308 273 114 209 522 315
39 286 177 388 266 114 209 522 315
41 150 222 200 262 146 238 508 297
41 177 222 233 266 146 238 508 297
41 226 206 298 266 146 238 508 297
41 273 185 378 269 146 238 508 297
