295 4 139 141 278 8 15 229 197
295 494 164 630 402 325 171 549 407
295 1 229 225 475 147 133 320 387
297 496 197 638 386 319 192 532 384
297 2 243 222 478 142 153 330 366
