54 382 238 442 348 5 88 613 577
54 221 248 299 545 5 88 613 577
54 292 181 371 500 5 88 613 577
57 216 246 309 547 13 81 608 585
57 280 187 375 502 13 81 608 585
60 383 242 436 324 2 78 608 582
60 283 185 354 500 2 78 608 582
60 215 244 301 544 2 78 608 582
