146 38 31 350 570 18 188 327 622
150 34 3 359 573 6 222 325 622
153 35 7 360 572 14 225 337 636
154 32 15 358 579 6 227 342 619
155 52 10 322 298 25 237 345 597
