353 285 89 318 317 293 176 312 203
353 600 79 636 323 616 174 637 207
353 100 95 150 321 119 198 150 217
353 2 81 50 321 12 175 57 196
353 343 76 393 332 364 182 382 212
353 577 72 628 331 585 180 622 209
353 477 83 534 325 490 181 527 214
353 422 72 512 333 449 118 488 212
353 8 82 127 326 66 180 112 212
353 174 73 293 333 238 116 287 209
353 79 78 205 329 148 165 197 201
353 319 61 444 344 389 108 446 220
353 471 68 604 342 530 172 583 217
