370 142 173 217 286 408 137 581 313
370 452 150 535 315 408 137 581 313
371 139 165 219 283 407 136 584 313
371 451 149 536 325 407 136 584 313
374 141 177 210 288 398 125 581 309
374 452 146 543 321 398 125 581 309
