272 538 81 576 208 151 252 427 366
272 591 51 638 221 151 252 427 366
272 287 71 358 281 151 252 427 366
272 189 73 266 283 151 252 427 366
272 364 47 499 330 151 252 427 366
