108 400 130 594 477 239 253 536 476
108 288 119 485 476 239 253 536 476
108 147 82 361 415 239 253 536 476
108 20 113 333 474 239 253 536 476
109 370 78 458 238 241 190 515 439
109 178 103 284 248 241 190 515 439
109 449 130 576 335 241 190 515 439
109 59 78 183 317 241 190 515 439
