245 323 21 463 359 6 129 566 325
245 381 33 562 379 6 129 566 325
245 190 34 357 413 6 129 566 325
245 254 17 467 400 6 129 566 325
245 99 10 308 476 6 129 566 325
