113 91 31 284 329 198 166 276 283
113 91 31 284 329 165 223 305 397
113 91 31 284 329 258 140 418 296
113 91 31 284 329 245 266 471 409
113 91 31 284 329 158 347 398 485
113 91 31 284 329 220 390 462 570
