56 174 91 352 356 1 2 423 638
57 94 62 295 638 94 2 296 63
57 94 62 295 638 1 2 91 638
57 94 62 295 638 297 3 425 640
60 186 94 346 363 2 5 422 637
60 95 62 294 635 2 5 422 637
