131 332 74 448 314 270 121 434 452
139 326 60 459 310 270 122 450 452
140 250 2 328 156 173 24 370 274
140 480 4 586 127 449 14 605 234
140 334 75 453 312 270 121 440 446
141 252 2 338 149 181 21 366 264
141 483 1 598 141 433 4 616 236
141 346 74 452 313 266 118 433 448
