175 122 174 223 436 223 238 296 286
175 122 174 223 436 176 343 330 460
175 122 174 223 436 294 265 507 384
175 122 174 223 436 198 262 413 447
176 120 178 236 433 199 263 410 449
