11 298 128 395 264 265 242 473 417
18 383 92 487 321 393 214 569 351
18 40 143 180 397 30 261 222 437
18 263 111 427 365 254 231 467 388
19 44 142 181 398 31 267 220 436
20 400 109 491 286 399 222 583 347
20 292 118 389 361 250 242 455 377
20 55 147 171 388 27 262 225 435
