245 271 27 443 254 6 126 613 368
245 424 25 567 379 6 126 613 368
245 32 46 190 383 6 126 613 368
284 267 23 447 256 344 109 397 147
284 419 19 575 382 475 161 531 199
284 26 43 195 387 120 130 151 160
285 268 16 444 254 350 111 393 135
285 423 22 571 381 507 175 532 191
285 29 42 191 383 127 128 148 141
