152 243 93 324 172 185 114 305 186
152 85 206 213 287 82 213 190 310
152 225 339 362 437 184 349 332 454
152 389 409 545 510 358 414 533 530
153 392 419 550 508 359 419 535 536
154 509 418 559 471 358 425 527 522
154 313 351 368 414 187 362 334 452
154 143 214 219 266 78 215 186 310
154 254 94 324 158 187 113 290 188
155 250 93 315 165 190 108 315 182
155 436 417 541 482 358 432 518 523
155 118 204 218 280 76 222 192 302
155 240 343 363 410 189 358 312 436
156 244 97 318 170 189 103 287 185
156 94 209 215 285 74 218 186 306
156 220 346 361 436 186 348 328 450
156 392 422 551 511 358 430 522 534
