101 453 144 609 369 73 242 288 415
139 456 151 600 365 414 204 595 421
139 291 89 430 326 286 152 462 379
140 357 92 441 331 287 147 429 381
140 455 144 610 363 422 202 596 428
141 456 145 607 371 415 204 600 427
141 287 87 437 333 280 154 464 389
