38 562 177 587 217 494 206 633 223
38 57 186 104 228 48 222 116 245
38 244 180 292 233 234 222 313 246
39 548 179 590 224 495 209 633 228
39 55 188 100 237 52 222 112 247
39 242 180 305 237 235 224 316 246
40 577 174 585 180 542 99 611 190
40 99 172 110 184 65 102 141 190
40 84 173 95 185 65 102 141 190
40 548 181 589 213 501 208 629 222
40 58 187 98 223 54 221 110 244
40 245 180 290 229 227 227 316 245
41 242 176 309 235 234 224 317 246
