283 29 15 342 637 170 272 207 294
283 29 15 342 637 130 82 158 172
284 26 14 348 636 170 272 210 302
284 26 14 348 636 126 80 158 143
285 35 20 326 634 170 274 206 302
288 26 19 348 635 135 83 151 128
