38 146 346 162 366 76 6 637 422
40 172 350 180 369 74 9 630 423
41 159 343 173 366 74 6 633 428
42 438 354 467 373 74 27 634 430
42 144 350 188 373 74 27 634 430
42 210 373 258 397 74 27 634 430
