108 539 118 637 444 117 275 635 478
108 268 99 455 314 117 275 635 478
108 336 126 546 373 117 275 635 478
109 35 89 123 311 105 261 639 474
109 275 111 468 320 105 261 639 474
109 490 114 637 465 105 261 639 474
109 333 106 555 371 105 261 639 474
109 1 97 250 473 105 261 639 474
