67 289 182 361 230 50 121 591 325
73 393 188 415 217 75 153 572 331
73 293 194 317 225 75 153 572 331
73 417 198 449 225 75 153 572 331
73 352 185 386 213 75 153 572 331
73 408 177 433 221 75 153 572 331
73 283 181 361 229 75 153 572 331
