371 326 404 334 426 304 330 319 346
371 414 406 422 432 317 260 350 306
371 399 407 413 434 354 346 373 367
371 270 401 288 433 220 305 246 337
371 366 402 394 453 383 309 403 330
373 323 403 333 422 332 302 346 325
373 413 405 428 431 366 322 390 344
