446 376 211 418 354 379 269 391 300
446 293 207 346 367 299 266 310 289
446 421 164 468 372 424 254 435 280
446 234 169 283 386 270 251 286 280
446 154 180 216 385 190 259 210 308
