53 147 142 296 419 610 219 626 269
53 147 142 296 419 619 235 636 287
53 147 142 296 419 603 254 624 305
53 84 106 222 421 610 219 626 269
53 84 106 222 421 619 235 636 287
53 84 106 222 421 603 254 624 305
53 236 84 392 420 610 219 626 269
53 236 84 392 420 619 235 636 287
53 236 84 392 420 603 254 624 305
53 379 81 556 420 610 219 626 269
53 379 81 556 420 619 235 636 287
53 379 81 556 420 603 254 624 305
