152 339 111 456 255 328 133 417 256
152 142 162 347 317 109 185 299 325
153 330 113 454 254 315 137 411 258
153 141 150 347 317 94 168 302 339
154 328 113 461 254 343 138 415 258
154 136 164 346 317 120 185 297 332
155 234 118 334 280 102 199 294 321
155 360 87 467 246 335 126 399 251
156 342 106 458 257 324 141 418 250
156 140 158 347 315 104 182 304 327
