146 177 74 430 245 160 138 507 325
152 143 62 462 269 156 149 527 339
153 159 62 415 226 149 150 524 334
154 179 74 435 266 186 143 500 329
155 184 73 433 257 179 156 505 333
156 158 75 431 244 178 138 512 334
