369 160 24 332 371 2 14 346 269
370 167 43 317 420 2 18 333 279
371 154 42 330 420 2 9 336 278
373 164 38 334 427 5 15 335 265
374 168 46 327 423 1 49 327 235
