31 230 245 261 320 1 118 613 350
31 196 217 223 308 1 118 613 350
31 148 186 180 272 1 118 613 350
34 152 164 179 206 1 78 637 344
34 313 261 353 317 1 78 637 344
34 265 249 296 330 1 78 637 344
34 179 175 210 257 1 78 637 344
34 233 245 265 327 1 78 637 344
34 143 186 178 270 1 78 637 344
34 212 188 256 261 1 78 637 344
34 182 209 226 309 1 78 637 344
38 439 182 452 248 1 126 639 350
38 178 172 198 221 1 126 639 350
38 466 179 487 232 1 126 639 350
38 154 162 178 211 1 126 639 350
38 320 259 345 309 179 277 412 389
38 498 156 519 222 1 126 639 350
38 274 199 302 253 1 126 639 350
38 310 179 337 237 1 126 639 350
38 144 190 167 255 1 126 639 350
38 264 249 293 304 179 277 412 389
38 371 206 398 269 1 126 639 350
38 235 252 266 313 179 277 412 389
38 191 211 219 285 1 126 639 350
38 209 186 248 249 1 126 639 350
38 384 168 438 232 1 126 639 350
42 142 164 178 202 1 93 633 344
42 173 170 206 230 1 93 633 344
42 315 266 355 319 172 286 420 391
42 207 188 259 232 1 93 633 344
42 264 251 301 321 172 286 420 391
42 232 241 265 324 172 286 420 391
42 496 154 528 248 1 93 633 344
42 138 186 179 264 1 93 633 344
42 186 210 233 314 172 286 420 391
