215 146 18 376 399 145 171 187 226
215 146 18 376 399 154 97 191 165
217 180 18 368 425 147 92 195 169
218 150 18 375 401 145 174 188 223
218 150 18 375 401 156 98 190 163
