115 171 46 362 354 256 221 418 375
115 351 26 601 405 256 221 418 375
118 172 44 363 361 255 219 416 372
118 349 26 600 405 255 219 416 372
120 173 40 365 355 251 219 419 374
