56 174 257 217 312 94 44 637 414
60 283 111 329 147 98 58 638 420
61 556 126 591 166 98 47 637 419
61 289 106 327 150 98 47 637 419
61 545 230 583 276 98 47 637 419
61 171 252 221 314 98 47 637 419
