185 377 75 408 170 46 330 257 630
185 6 58 62 312 46 330 257 630
185 173 42 254 330 46 330 257 630
185 221 8 348 254 46 330 257 630
185 140 184 336 594 46 330 257 630
