38 266 213 294 258 127 209 639 356
38 307 221 335 269 127 209 639 356
38 406 253 439 296 127 209 639 356
38 213 204 250 248 127 209 639 356
38 358 228 390 282 127 209 639 356
39 212 210 246 252 118 215 638 353
39 350 230 386 278 118 215 638 353
39 304 219 337 271 118 215 638 353
39 398 254 438 298 118 215 638 353
39 258 215 297 264 118 215 638 353
41 399 256 440 294 125 207 638 353
41 259 214 297 261 125 207 638 353
41 207 206 248 250 125 207 638 353
41 358 230 398 280 125 207 638 353
41 302 221 341 276 125 207 638 353
