146 190 58 405 288 102 146 483 394
152 188 53 410 294 99 138 490 399
153 187 54 412 294 96 141 486 399
154 190 58 405 288 102 153 478 389
155 190 61 407 294 76 153 480 394
