314 221 112 277 266 58 152 454 381
319 424 190 514 369 59 157 452 379
320 225 111 273 272 61 156 455 380
323 429 192 472 359 60 155 455 379
323 222 111 277 273 60 155 455 379
323 425 191 513 371 60 155 455 379
