456 318 126 379 218 341 166 373 217
456 166 12 356 155 154 89 292 158
457 182 16 358 144 144 81 278 159
459 186 17 358 149 148 86 280 157
461 195 18 356 143 154 92 279 153
