583 426 143 435 157 432 1 639 257
583 478 110 494 128 432 1 639 257
583 295 179 314 205 432 1 639 257
583 371 219 392 272 432 1 639 257
583 378 142 395 219 432 1 639 257
583 219 133 242 200 432 1 639 257
583 287 206 315 273 432 1 639 257
583 187 152 226 271 432 1 639 257
583 439 163 483 275 432 1 639 257
583 395 125 430 278 432 1 639 257
583 239 112 272 275 432 1 639 257
583 460 118 536 278 432 1 639 257
583 80 50 275 279 432 1 639 257
