576 567 106 594 143 554 90 600 119
576 145 89 277 310 187 30 328 77
576 145 89 277 310 44 66 155 211
577 146 74 290 319 180 20 340 110
577 146 74 290 319 31 54 165 219
582 180 90 281 304 188 32 334 82
