11 50 2 165 202 62 73 152 252
11 539 112 639 391 520 191 638 392
11 350 56 479 330 317 170 475 370
11 206 19 372 270 198 160 350 374
18 228 40 285 102 199 141 264 246
18 2 1 106 154 1 85 93 246
18 62 1 166 184 62 98 152 242
18 539 115 639 389 523 233 637 390
18 359 62 471 327 323 174 473 366
18 212 21 367 322 203 156 329 367
19 109 4 166 150 88 88 155 243
19 11 1 103 138 14 67 94 275
19 541 109 638 343 524 237 635 383
19 346 45 486 242 309 176 484 375
19 230 12 377 223 202 145 337 371
20 234 29 361 270 210 142 332 362
20 339 62 474 299 328 162 444 353
