337 261 241 333 349 407 240 430 254
337 286 232 358 356 407 240 430 254
337 437 247 537 347 407 240 430 254
340 377 247 401 330 405 240 432 254
340 468 234 509 348 405 240 432 254
