108 106 182 364 418 158 230 636 413
109 67 113 99 151 2 139 82 172
109 124 106 153 160 147 125 182 175
109 178 100 207 160 147 125 182 175
109 82 114 122 165 2 139 82 172
109 276 108 313 166 226 138 290 191
109 202 110 238 171 226 138 290 191
109 232 102 281 148 226 138 290 191
109 214 151 290 245 228 234 637 417
109 558 106 638 252 602 195 639 220
109 394 134 505 289 228 234 637 417
109 494 178 637 338 228 234 637 417
109 108 184 359 418 228 234 637 417
