244 29 136 388 224 38 81 416 313
245 93 388 226 620 2 417 406 614
245 30 131 385 233 7 87 480 323
245 348 3 481 318 7 87 480 323
245 201 366 390 620 2 417 406 614
