38 196 158 229 218 155 218 564 426
38 321 199 458 324 155 218 564 426
39 175 159 227 282 152 217 566 430
39 320 200 462 326 152 217 566 430
41 185 157 236 263 126 201 583 421
41 332 196 407 330 126 201 583 421
