131 389 60 479 190 400 99 515 265
131 50 35 158 180 39 70 158 265
131 156 92 266 255 167 182 297 433
138 387 62 481 194 397 73 525 259
138 47 38 155 192 55 63 158 278
138 162 88 271 271 155 146 290 449
139 401 64 473 199 407 84 521 269
139 60 50 150 174 41 82 162 286
139 169 94 281 210 158 153 297 449
140 386 58 510 194 389 77 520 286
140 48 42 166 201 48 62 167 282
140 162 86 298 277 154 149 292 443
141 391 58 488 201 388 71 528 267
141 47 40 158 198 46 67 160 286
141 152 87 305 282 152 142 294 453
