64 583 270 598 301 70 50 637 446
64 582 258 603 286 70 50 637 446
64 569 264 586 304 70 50 637 446
64 602 255 638 302 70 50 637 446
64 595 287 636 350 70 50 637 446
64 38 272 73 372 70 50 637 446
64 49 279 86 379 70 50 637 446
