247 224 14 266 100 230 48 250 97
247 257 34 314 174 252 87 273 132
247 365 33 418 203 366 84 398 149
247 186 21 242 187 191 97 222 154
247 478 46 545 187 492 94 525 150
247 106 56 186 182 124 104 164 165
247 285 27 365 195 292 67 343 129
247 412 23 503 192 435 82 470 147
248 414 5 447 71 426 42 450 74
248 225 20 270 81 240 59 262 89
248 293 14 354 76 320 18 349 52
248 25 32 76 106 41 65 62 98
248 249 37 307 205 252 86 277 122
248 494 55 561 203 508 101 533 144
248 186 52 253 206 204 104 228 139
248 117 54 192 204 142 121 172 162
248 364 34 431 204 369 94 395 130
248 430 35 502 206 446 99 473 142
248 282 40 367 206 308 80 335 110
