146 93 190 340 376 54 209 265 401
146 323 173 534 394 334 205 544 420
153 323 170 534 392 333 205 545 427
153 91 190 341 378 53 206 266 404
155 323 175 533 392 337 208 541 422
155 94 192 338 378 54 212 263 407
156 326 176 451 381 339 213 544 424
156 121 196 340 373 51 218 268 403
