18 323 118 441 337 264 215 506 375
19 247 114 396 323 202 207 451 351
19 301 110 458 341 255 211 519 361
20 257 116 382 312 211 209 451 355
20 300 117 439 339 249 215 505 364
