539 48 107 318 479 191 227 281 389
540 41 112 303 466 182 235 300 386
542 50 110 295 480 190 228 286 382
542 260 137 528 478 190 228 286 382
544 47 110 296 476 187 226 280 381
