38 457 222 516 274 99 187 618 305
38 290 233 369 283 99 187 618 305
39 459 220 519 281 99 186 619 297
41 460 221 515 276 96 166 625 299
41 291 232 368 278 96 166 625 299
