38 501 334 509 343 429 343 566 367
38 262 339 270 350 242 340 278 356
38 248 340 256 351 242 340 278 356
38 296 333 306 342 262 325 333 342
38 596 340 606 351 590 326 615 353
38 436 346 448 359 429 343 566 367
38 482 347 532 362 429 343 566 367
