576 116 166 163 221 98 143 182 199
576 154 208 338 477 44 188 346 398
576 320 202 518 476 325 70 573 278
577 178 211 338 480 60 161 338 345
577 334 207 519 470 338 38 578 205
582 164 205 330 478 50 190 338 359
582 321 201 514 477 333 65 570 202
