245 329 89 637 426 2 255 639 425
245 50 73 399 425 2 255 639 425
284 331 95 633 424 474 255 504 279
285 329 99 630 423 474 256 505 278
285 55 74 391 422 474 256 505 278
288 358 102 631 423 476 259 500 278
