470 283 262 339 442 269 433 356 444
470 196 258 269 429 182 415 284 430
470 315 253 379 462 262 442 401 467
471 265 259 337 427 254 416 332 440
471 316 250 378 451 297 446 386 461
471 182 264 265 427 194 405 252 446
471 393 245 514 467 372 469 457 475
472 391 237 477 479 259 441 404 475
