138 227 55 452 368 218 126 447 632
138 28 41 256 360 15 131 250 633
139 1 38 58 142 3 97 70 240
139 82 26 260 191 81 157 250 572
139 289 38 456 259 268 134 410 572
140 239 51 448 392 211 219 392 632
