29 87 430 154 609 263 144 308 187
29 87 430 154 609 103 153 154 213
29 87 430 154 609 330 206 405 257
29 87 430 154 609 139 75 211 130
29 87 430 154 609 330 1 399 85
