248 54 106 326 475 55 205 420 462
248 276 84 616 491 55 205 420 462
249 52 114 325 478 56 210 417 459
249 274 89 604 490 56 210 417 459
250 98 117 237 222 60 227 400 458
250 266 98 595 392 60 227 400 458
