152 138 140 379 472 136 208 356 520
153 145 145 383 468 138 226 374 520
154 140 137 384 475 136 222 351 525
155 145 141 383 473 143 229 357 520
156 117 151 380 456 133 242 356 512
