38 341 299 381 405 2 139 423 467
40 90 345 142 417 1 137 421 460
40 337 301 381 408 1 137 421 460
41 334 293 380 407 2 386 424 476
41 86 333 145 421 2 386 424 476
42 335 286 389 411 14 347 413 476
