152 260 4 533 297 4 107 632 417
153 258 4 515 294 6 55 637 420
154 264 2 516 301 5 60 637 421
155 265 1 522 302 2 54 639 419
156 261 2 512 306 12 66 635 416
