476 275 35 518 271 231 264 500 283
478 297 36 516 279 230 247 512 299
479 300 32 512 281 242 259 494 291
480 298 38 515 282 236 259 496 290
481 299 35 516 284 235 253 504 291
