131 478 138 566 450 340 120 524 419
131 151 19 277 253 90 142 310 420
139 153 24 274 282 90 140 332 410
141 486 159 565 435 357 149 494 425
141 167 15 275 257 100 150 313 404
