38 398 126 421 146 294 64 572 202
41 424 306 453 330 391 318 618 360
42 119 154 134 187 13 150 260 245
42 399 126 421 149 292 94 576 203
42 131 162 148 195 13 150 260 245
42 98 155 117 189 13 150 260 245
42 199 156 218 194 13 150 260 245
42 168 155 193 194 13 150 260 245
42 146 151 168 196 13 150 260 245
42 469 273 501 330 391 318 619 363
