11 280 72 384 290 284 148 383 300
11 141 70 260 370 167 191 263 388
11 375 53 494 383 371 187 500 399
18 467 60 526 219 474 122 517 213
18 102 218 258 367 151 189 272 398
18 270 66 384 291 273 149 387 301
18 375 46 496 385 377 183 503 405
18 136 70 271 376 151 189 272 398
19 475 61 516 215 484 122 508 229
19 110 225 250 364 159 188 251 388
19 278 74 383 283 276 160 379 301
19 143 77 252 370 159 188 251 388
19 377 50 492 381 383 180 482 402
20 463 59 520 219 481 129 518 227
20 267 72 385 292 283 144 385 301
20 373 47 494 387 374 177 495 391
20 107 72 262 376 143 186 247 393
