1 147 268 193 346 38 200 280 334
1 147 268 193 346 58 4 597 260
1 87 288 130 386 38 200 280 334
1 87 288 130 386 58 4 597 260
3 147 265 207 343 34 13 607 246
6 319 144 347 170 98 19 552 254
7 88 285 138 395 36 6 612 251
