133 123 15 341 338 106 55 298 477
139 108 17 335 328 106 59 298 478
140 101 17 333 331 101 60 296 477
141 107 20 332 330 94 59 290 480
142 112 19 334 332 94 58 296 471
