152 172 2 584 454 84 77 565 442
153 221 1 531 441 57 67 547 454
154 280 15 518 384 74 76 507 448
155 234 2 518 445 40 66 552 451
156 230 2 517 438 64 79 544 440
