146 226 9 451 194 46 42 546 366
152 222 13 443 211 60 54 540 358
153 222 12 431 206 62 60 539 351
154 219 7 439 212 58 56 543 358
155 225 10 442 209 60 60 539 354
