247 19 99 287 637 272 477 362 481
247 19 99 287 637 269 464 357 470
247 19 99 287 637 265 446 355 458
247 19 99 287 637 231 336 322 388
248 27 96 287 635 226 336 322 384
