75 442 66 466 104 537 85 634 237
75 442 66 466 104 401 96 561 282
75 442 66 466 104 6 27 255 477
75 442 66 466 104 100 48 585 422
75 599 98 638 320 537 85 634 237
75 599 98 638 320 401 96 561 282
75 599 98 638 320 6 27 255 477
75 599 98 638 320 100 48 585 422
