108 338 134 415 229 119 227 584 400
108 40 140 152 256 119 227 584 400
108 452 141 587 279 119 227 584 400
109 305 130 430 282 101 214 617 427
109 3 138 178 423 101 214 617 427
109 411 136 620 383 101 214 617 427
