108 397 166 501 247 6 242 508 425
108 217 122 302 300 6 242 508 425
108 130 118 257 304 6 242 508 425
108 1 8 137 360 6 242 508 425
108 431 30 637 424 6 242 508 425
