1 539 290 571 349 29 55 569 239
1 574 337 599 418 29 55 569 239
1 583 279 615 347 29 55 569 239
1 309 342 340 412 29 55 569 239
1 507 342 543 417 29 55 569 239
6 427 83 454 122 50 43 571 278
7 452 92 467 109 66 50 566 229
