576 460 115 569 296 456 50 578 138
576 302 59 399 388 339 42 434 174
577 453 62 561 295 452 47 582 145
577 304 57 404 390 332 33 436 177
582 460 106 551 294 455 50 578 134
582 309 62 391 380 332 41 431 175
