60 196 265 222 333 13 3 363 496
60 230 225 269 344 13 3 363 496
60 150 215 198 370 13 3 363 496
60 278 138 366 465 13 3 363 496
60 35 167 154 469 13 3 363 496
61 119 258 139 315 4 4 368 493
61 117 236 147 324 4 4 368 493
61 183 245 227 326 4 4 368 493
61 191 235 246 336 4 4 368 493
61 218 233 270 343 4 4 368 493
61 38 172 153 498 4 4 368 493
61 241 155 374 491 4 4 368 493
