576 142 191 357 637 137 112 446 210
577 166 153 189 187 159 144 193 154
577 418 143 476 374 386 102 478 148
577 133 202 353 637 128 119 445 206
582 428 143 479 378 408 106 478 146
582 158 202 347 634 139 118 438 206
