138 38 94 126 244 17 140 137 363
138 231 50 366 236 211 123 399 407
138 422 43 545 247 378 133 597 403
139 141 98 195 166 143 118 197 207
139 106 91 165 232 109 126 156 346
139 2 86 71 250 1 163 64 348
139 174 88 254 238 134 126 266 342
139 30 84 119 253 23 145 123 372
139 238 55 350 261 211 117 377 414
139 418 39 541 246 388 124 573 409
140 101 94 146 147 115 128 147 331
140 142 99 187 159 154 130 189 219
140 16 90 75 184 5 170 51 333
140 175 90 248 225 181 142 261 324
140 42 87 117 244 53 146 127 364
140 241 56 346 259 216 128 373 410
140 426 46 542 239 404 136 566 405
141 113 86 178 134 124 133 199 208
141 190 80 239 170 161 142 260 294
141 15 83 62 181 6 171 62 294
141 47 82 119 181 73 152 138 342
141 252 58 351 173 223 128 374 406
141 434 30 551 173 394 136 557 390
