38 346 298 379 347 238 15 396 362
38 304 290 346 346 238 15 396 362
40 344 297 380 347 154 14 402 361
40 306 294 347 345 154 14 402 361
41 338 294 385 349 146 7 407 370
41 295 287 350 350 146 7 407 370
