176 324 186 449 371 190 220 368 378
176 198 82 348 374 190 220 368 378
177 195 84 346 375 189 213 368 378
180 599 141 638 182 579 166 604 186
180 191 74 349 378 190 210 379 378
