505 304 278 318 295 318 118 442 287
505 541 390 555 408 318 118 442 287
505 490 282 506 302 318 118 442 287
505 506 277 524 295 318 118 442 287
505 130 409 146 432 318 118 442 287
