146 119 110 209 221 5 160 315 424
153 355 103 443 275 305 199 535 419
154 416 109 469 232 303 190 503 409
154 534 91 624 190 514 191 615 258
154 364 106 445 402 303 190 503 409
155 358 106 439 283 287 192 576 394
