190 310 102 347 175 3 2 638 510
191 410 142 457 234 9 1 635 510
191 263 121 309 232 9 1 635 510
191 234 140 291 235 9 1 635 510
191 245 129 300 230 9 1 635 510
191 342 130 402 231 9 1 635 510
191 386 145 470 243 9 1 635 510
191 186 126 290 297 9 1 635 510
191 143 142 278 350 9 1 635 510
191 86 134 229 387 9 1 635 510
191 364 126 546 351 9 1 635 510
191 402 138 634 502 9 1 635 510
191 28 156 302 510 9 1 635 510
