567 253 79 297 151 337 98 595 276
567 314 79 357 155 337 98 595 276
567 430 126 487 208 337 98 595 276
567 501 171 580 317 337 98 595 276
568 384 135 421 162 341 121 596 265
572 381 134 424 162 339 119 596 267
572 430 134 487 203 339 119 596 267
572 496 114 563 201 339 119 596 267
573 380 133 413 170 334 120 596 264
573 429 139 487 197 334 120 596 264
573 501 115 565 195 334 120 596 264
