494 97 33 467 338 5 315 32 359
494 97 33 467 338 64 315 114 352
494 97 33 467 338 1 498 38 557
494 97 33 467 338 78 435 128 495
494 97 33 467 338 194 426 252 482
494 97 33 467 338 158 450 222 506
494 97 33 467 338 4 554 65 615
494 97 33 467 338 337 519 409 578
