475 127 341 155 472 91 370 201 422
477 126 347 153 472 95 372 199 421
477 116 98 385 339 24 291 342 375
478 109 91 390 346 19 289 352 379
479 111 94 387 347 21 292 344 378
480 111 85 392 342 14 290 346 380
481 114 338 158 476 98 372 205 422
481 93 107 358 355 28 285 341 378
