152 241 75 516 520 50 225 572 566
153 230 86 517 417 60 194 612 555
154 239 81 522 473 57 183 628 560
155 225 90 517 425 61 195 610 560
156 224 82 529 497 50 191 621 565
