470 3 155 86 404 4 376 88 449
470 518 140 598 399 463 369 589 400
470 281 124 375 398 287 372 400 436
470 84 142 187 410 101 381 182 451
470 182 126 279 420 190 395 311 450
470 427 127 531 416 429 385 531 432
471 6 150 86 425 1 375 91 447
471 514 137 599 399 512 365 602 415
471 90 140 181 414 101 369 186 444
471 280 125 373 399 286 358 425 444
471 432 121 519 428 429 378 535 449
471 182 123 278 415 193 386 282 447
472 3 144 91 421 60 420 74 450
472 280 125 372 394 295 362 398 438
472 86 144 187 417 85 402 178 442
472 429 121 529 413 437 408 539 444
472 181 123 285 426 192 387 292 450
