46 6 1 366 638 151 416 333 585
48 190 89 475 619 154 434 318 582
48 14 11 362 638 154 434 318 582
51 182 75 478 636 142 438 320 582
51 9 10 358 640 142 438 320 582
