53 340 210 389 332 306 298 440 351
53 373 210 430 326 306 298 440 351
53 205 192 272 415 306 298 440 351
53 438 221 521 428 306 298 440 351
53 512 232 631 425 306 298 440 351
