94 475 184 551 323 1 247 527 424
94 1 22 77 424 1 247 527 424
94 60 137 231 376 1 247 527 424
94 181 155 355 424 1 247 527 424
94 243 201 477 425 1 247 527 424
