108 131 109 271 273 143 252 406 283
108 326 124 490 275 143 252 406 283
108 493 81 637 318 194 297 639 437
108 35 106 186 353 143 252 406 283
108 1 2 311 480 194 297 639 437
109 368 126 487 275 137 242 638 478
109 122 110 273 274 137 242 638 478
109 26 98 170 326 137 242 638 478
109 490 82 635 320 137 242 638 478
109 2 1 293 475 137 242 638 478
