11 334 238 378 354 333 282 378 372
11 365 260 434 410 369 324 440 448
18 374 266 427 389 362 333 439 443
19 310 216 326 242 308 243 324 269
19 334 240 372 318 343 320 374 358
19 372 254 430 360 377 368 425 429
20 347 223 377 255 340 245 378 258
20 305 213 329 266 305 226 332 264
20 333 238 378 358 338 294 377 358
20 365 263 423 392 373 330 434 441
