583 626 232 628 243 488 225 504 247
583 612 246 618 253 488 225 504 247
583 612 246 618 253 386 215 402 238
583 632 232 638 246 488 225 504 247
583 632 232 638 246 386 215 402 238
583 572 234 577 252 488 225 504 247
583 572 234 577 252 386 215 402 238
583 584 237 592 259 488 225 504 247
583 584 237 592 259 386 215 402 238
583 596 237 605 258 488 225 504 247
583 596 237 605 258 386 215 402 238
583 483 241 500 263 488 225 504 247
583 483 241 500 263 386 215 402 238
