38 327 237 346 270 173 237 488 338
38 412 226 440 262 173 237 488 338
38 322 254 354 285 173 237 488 338
38 272 253 302 292 173 237 488 338
38 370 223 400 278 173 237 488 338
39 415 226 442 268 154 232 485 335
41 270 246 306 297 162 231 485 344
