11 394 106 592 330 353 174 605 358
18 205 146 333 299 172 218 324 322
18 86 126 253 307 62 194 238 334
18 404 111 595 321 354 196 615 346
19 251 100 347 286 226 211 342 326
19 102 94 240 261 54 188 223 351
19 409 75 593 275 382 202 596 355
20 190 138 331 299 168 206 336 325
20 100 125 236 307 66 206 214 328
20 402 107 590 326 352 180 575 355
