154 10 184 33 255 4 256 25 284
154 418 128 450 182 405 151 446 197
154 588 98 630 144 568 126 634 198
154 462 140 513 226 421 217 510 382
154 257 137 302 235 241 204 316 274
154 114 182 175 270 94 250 166 303
154 327 158 409 305 295 209 438 350
154 21 196 102 383 2 294 95 380
154 132 189 270 317 72 287 322 391
154 520 161 630 328 450 278 639 423
155 412 125 453 182 397 147 445 197
155 186 149 234 204 157 189 198 216
155 5 182 58 263 1 249 36 306
155 566 93 634 168 563 118 637 201
155 246 142 318 215 236 179 322 264
155 454 126 531 259 414 211 544 383
155 312 146 417 310 275 202 441 345
155 12 190 112 397 3 262 149 408
155 130 188 280 330 58 286 341 415
155 472 151 635 403 446 267 638 414
155 39 270 354 418 58 286 341 415
