383 273 1 638 477 242 249 589 456
385 308 150 421 374 242 264 586 456
385 2 1 122 475 242 264 586 456
385 399 104 618 387 242 264 586 456
385 151 58 362 382 242 264 586 456
385 10 2 254 462 242 264 586 456
385 372 2 638 477 242 264 586 456
