146 125 34 472 235 163 99 561 408
152 114 29 472 248 147 124 562 402
153 122 39 460 254 143 170 556 402
154 115 34 475 262 144 94 568 404
155 123 34 472 309 162 106 571 402
156 123 31 471 299 162 96 561 408
