214 118 52 274 353 398 221 426 246
214 118 52 274 353 321 293 349 331
214 118 52 274 353 379 237 418 270
214 118 52 274 353 334 283 381 326
218 384 114 550 338 380 226 430 276
