370 126 463 134 477 114 370 187 433
370 208 463 226 479 95 99 354 253
370 467 451 487 476 481 418 502 437
370 366 444 390 479 279 41 362 84
370 366 444 390 479 427 116 593 206
370 402 434 449 474 410 294 489 356
370 262 416 334 478 358 314 383 332
