152 168 92 244 223 188 129 259 231
152 228 68 394 254 207 110 427 333
153 167 92 247 222 176 132 259 233
153 220 68 397 245 204 100 432 335
154 221 63 399 239 183 120 462 325
156 227 76 405 272 215 146 422 340
