108 370 279 478 345 1 239 478 602
108 2 110 134 249 1 239 478 602
108 354 153 478 302 1 239 478 602
108 329 469 478 604 1 239 478 602
108 238 121 380 293 1 239 478 602
108 136 60 293 260 1 239 478 602
109 387 153 478 305 1 237 474 638
109 281 95 385 278 1 237 474 638
109 3 95 136 250 1 237 474 638
109 144 47 278 254 1 237 474 638
