146 430 97 578 369 110 169 561 418
146 264 68 418 370 110 169 561 418
153 427 94 582 368 107 169 561 419
154 258 61 422 374 108 170 533 430
155 318 101 354 157 106 165 566 424
155 235 129 354 321 106 165 566 424
155 354 103 461 386 106 165 566 424
155 387 96 513 394 106 165 566 424
155 301 60 421 380 106 165 566 424
155 429 93 577 366 106 165 566 424
