419 32 223 255 608 283 401 374 444
420 25 215 257 614 281 397 381 449
423 269 227 423 635 282 398 379 449
426 119 213 250 614 280 399 380 448
426 277 202 425 640 280 399 380 448
426 27 211 257 607 280 399 380 448
