445 150 154 463 417 192 58 338 303
445 32 26 323 450 192 58 338 303
446 139 154 481 416 186 62 409 306
446 32 28 307 454 186 62 409 306
447 143 151 463 398 188 57 403 306
447 32 25 322 455 188 57 403 306
