108 131 223 233 329 1 323 423 637
108 2 214 126 337 1 323 423 637
108 270 206 391 367 1 323 423 637
108 308 223 425 396 1 323 423 637
109 143 218 220 322 4 323 425 635
