538 108 63 373 468 344 219 377 261
540 105 56 377 467 351 216 378 283
541 109 61 377 470 353 219 381 272
543 110 63 378 469 341 220 380 261
544 318 94 481 467 351 218 388 253
