312 3 55 90 257 122 192 236 214
312 3 55 90 257 150 220 301 237
312 3 55 90 257 135 390 227 420
312 3 55 90 257 114 239 292 259
312 3 55 90 257 53 246 274 271
312 3 55 90 257 70 294 246 328
312 3 55 90 257 84 258 279 291
312 3 55 90 257 46 278 266 309
312 3 55 90 257 8 309 246 350
312 3 55 90 257 13 336 254 382
312 358 38 636 420 122 192 236 214
312 358 38 636 420 150 220 301 237
312 358 38 636 420 135 390 227 420
312 358 38 636 420 114 239 292 259
312 358 38 636 420 53 246 274 271
312 358 38 636 420 70 294 246 328
312 358 38 636 420 84 258 279 291
312 358 38 636 420 46 278 266 309
312 358 38 636 420 8 309 246 350
312 358 38 636 420 13 336 254 382
