108 242 94 422 349 1 296 635 476
108 1 109 219 364 1 296 635 476
108 390 94 636 454 1 296 635 476
109 224 92 426 338 1 279 635 478
109 6 108 225 366 1 279 635 478
109 387 89 639 454 1 279 635 478
