138 171 144 202 209 9 171 181 263
138 187 144 291 249 31 178 367 362
138 337 110 439 245 270 168 526 361
139 167 150 194 225 110 181 342 349
139 193 150 294 237 25 194 356 300
139 351 95 456 241 270 174 522 345
140 172 142 201 211 7 194 269 342
140 189 138 293 254 31 173 367 375
140 350 110 445 247 260 170 530 355
141 339 98 443 268 265 158 521 342
