131 235 38 318 150 118 115 310 436
131 382 22 466 138 215 109 434 454
131 449 14 584 325 326 58 638 475
139 374 23 454 158 218 130 588 435
139 235 42 332 167 116 138 442 421
139 472 22 588 313 218 130 588 435
141 373 19 447 114 215 116 405 458
141 237 29 326 150 106 114 298 427
141 447 22 585 322 342 92 638 462
