453 293 58 373 352 286 107 354 243
453 384 79 481 344 404 125 465 276
453 172 101 280 353 174 131 222 311
453 31 8 157 350 107 58 160 195
453 485 70 638 352 505 39 636 98
456 386 92 491 355 405 131 461 254
456 289 66 389 353 289 110 354 241
456 155 103 276 353 175 136 220 299
456 489 58 638 352 501 53 634 98
456 23 16 171 354 109 60 156 187
458 482 62 637 345 488 49 640 102
